BBB<BBBBBB
B........B
B........B
B........B
B........B
B........B
B........B
B........B
B........B
BBBBBBBBBB
