BBB<BBBBBB
B........B
B........B
B........B
BWW....WWB
B.W....W.B
B.W....W.B
B.WW..WW.B
B........B
BBBBBBBBBB
