BBBBBBBBBBBBBKBB>BBB
B..................B
B..................B
B..................B
B..................B
B..................B
B..................B
B..................B
B..................B
BBBBdBBBBBBBBBBBBBBB
