SSSSSSSSSSSSSSSSSSSSSSSSSSSSSS
SS,SSS,S,,,,,,,,,SS,,,,S,,,,SS
S,,S,,SSS,,,,,S,,,S,,,,S,,,,,S
S,SS,,,,S,,,,SS,,,SS,,,S,,,,SS
S,,S,SS,SSSSSS,,,,,S,,,,,SS,SS
S,,SS,S,,,,SS,,,,,,,,SSS,,S,SS
S,,,SSS,,,,,SS,,,SSSS,,SSSSSSS
>,,,,SS,,,,,,SS,,S,,,,,,,,,,SS
S,,,,S,,,S,S,,SS,,,,SSS,,,,,SS
SS,,,S,,,SSS,,,SSS,,,,SSS,,,SS
SS,,,,,,,,,SSS,,,S,,,,S,SS,,SS
SS,,,S,,,,,S,,,,,SSS,,,,,S,,,S
S,,,,S,,,,,S,,,,,,,,,,,,,SS,,S
SS,,,S,,,,SS,,,,SSS,,,,,SSSSSS
SSSSSSSSSSSSSSSSSSSSSSSSSSSSSS
