SSSSSSSSSSSSSSS,SSSSSSSSSSSSSSSSSSSSSSSS
S,,,S,,,,,,SS,S,SSSSS,,,,,,,,,,,,,SS,,,S
S,S,,,SSSS,,,,S,SSSSS,SS,SSSSSSSS,SS,S,S
SS,,SS,,,SS,SS,,SSSS,,,SSS,,,SS,,,S,SS,S
S,,S,,,S,,SS,,,SSSSS,S,,,,,S,SS,SSS,,,,S
SS,S,SSSS,,,,SSSSSSS,SSSSSSS,SS,,,,,S,SS
S,,S,,,,,SSSSSS,,,,,,SS,,,,,,SSSSSSSS,SS
SS,,SSSS,,,,SSS,SSSSSSS,SSSSSSSSSS,,,,,S
S,,,,,,,SSS,S,,,S,,,,,S,,,,,SSSSSSSSSSSS
S,S,SSSSSSS,S,SSS,SSS,SSSSS,SSSSSSSSSSSS
S,S,SSSSSSS,S,,,,,SSS,SSSSS,SSSSSSSSSSSS
S,S,SSSS,,,,S,SSSSSSS,S,,,S,SSSSSSSSSSSS
S,S,,SSS,SSS,,S,,,SSS,S,S,S,SSSSSSSSSSSS
S,SS,,,S,,,,S,S,S,SSS,S,S,S,SSSSSSSSSSSS
S,,,SS,SSSS,S,S,S,S,,,S,S,S,SSS,,,,,SSSS
SSS,SS,S,,,,S,S,S,,,SSS,S,S,,,,,SSS,SSSS
S,S,SS,,,SSS,,S,SSSSS,,,S,SS,SSS,,,,SSSS
S,S,,,SSSSSSSS,,SSSSS,SSS,SSSSS,,SSSSSSS
S,,SS,,SSSS,,,,SSSSSS,S,,,SSSSS,SSSSSSSS
SS,,,S,SSSS,SSSSSSSSS,S,SSSSSSS,SSSSSSSS
SS,SS,,SSSS,,SSSSSSSS,S,SSSSSSS,SSSSSSSS
S,,S,,SSSSSS,,SSSSSSS,S,,,,,S,,,SSSSSSSS
SS,S,SSSSSSSS,SSSSSSS,,SSSS,,,SSSSSSSSSS
SS,S,SSSSSSS,,SSSSSSSS,,,SSSSSS,,,SSSSSS
SS,S,S,,,S,,,SSSSSSSSSSS,SSSSSS,S,,SSSSS
SS,S,S,S,,,SSSSSSSSSSSSS,,SSSSS,,S,SSSSS
SS,S,,,SSSSSSSSSSSSSSSSSS,,SSSSS,S,SSSSS
SS,,SSS,,,,,SSSSSSSSSSSSSS,SSSS,,S,,SSSS
SSS,,,,,SSS,,,SSSSSSSSSSSS,,,SS,SSS,SSSS
SSSSSSSSSSSSS,SSSSSSSSSSSSSS,SS,SSS,SSSS
SSSSSSSSSSSSS,SSSSSSSSSSSSS,,SS,SSS,SSSS
SSS,,,,,,,,,,,S,,,,SSSSSSS,,SSS,SSS,SSSS
S,,,SSSSSSSSSSS,SS,,,,SSS,,SS,,,SSS,,SSS
S,SS,,,,,,,SS,,,,,SSS,,,,,S,S,SSSSSS,SSS
S,S,,SSSSS,,SSSSS,,,,SSSSS,,,,S,,SS,,SSS
S,S,S,S,,,S,,S,,,SSS,,,,,,SSSSS,SS,,SSSS
S,S,,,,,S,,S,,,S,,,SSSSSS,,,,,,,S,,SSSSS
S,,SS,S,,S,,SSS,SS,SSSSSSSSSSSS,,,SSSSSS
SS,,,,SS,,,,,,,,,S,,,,,,,,,,,,,,SSSSSSSS
SSSSSSSSSSSSSSSSSSSSSSSSSSSSSSSSSSSSSSSS
