EEEEEEEEEEEEEEE>EEEEEEEEEEEEEEEEEEEEEEEE
EEEEE.......EEE.EE...........EEEEE.....E
EEEE..EEEEE...E.EE.EEEEEEEEE.EEEEE.EEE.E
EEEE.EEE...EE.E.EEEEEEEEEEEE.EEEE...EE.E
EEEE.E...E.EE.E.E............EEE..E..E.E
EEEE.E.EEE..E.E...EEEE.EEEEEEE...EEE.E.E
EEEE.E...EE.E.EEEE.....EEEE....EEEEE.E.E
EEE...EE.EE...EE...EEEEEEEE.EEEEEEEE.E.E
EEE.E.E..EEE.EE..EEEEEEEEEE.....EEE..E.E
EEE.EE..EEE..EE.EEEEEEEEEEEEEEE.EEE.E..E
EEE..E.EEEE.EE..EEEEEEEEEEEEEEE.EEE.E.EE
EE..E..E....E..EE.......EEEEEEE..EE.E.EE
EE.E..E..EEE..EEE.EEEEE..EEEEEEE..E.E.EE
E..E.EE.EEE..EEEE..EEEEE..EEEEEEE.E.E.EE
E.E..E..EE..EEEEEE.EEEEEE...EEEE..E.E.EE
E.E.E..E...EEEEE...EE.EEEEE.EEEE.EE.E.EE
E.E.E.E..EE....E.EEEE.......EEEE.E..E..E
E.E.E.E.EEE.EE.E.EEEE.EEEEEEEEE..E.EEE.E
E.E..EE..EE.E..E.EEEE...........EE.E...E
E.EE.EEE.EE.E.EE.EEEEEEEEEEEEEEEEE.EEEEE
E..E.EEE.EE.E.EE.EEEEEEEEEEEEEEEEE.EEEEE
EE.E.EE.....E.EE.EEEE......EEEE....E...E
EE.E..E.EEEE..EE.EEEE.EEEE.EEEE.EEEE.E.E
E...E.E.EEEE.EEE......E....EEEE....E.E.E
E.E.E.EKEEEE.E.EEEEEEEE.EEEEEEEEEE.E.E.E
E.EE..EEEEEE.E.E...EEEE....EEEE....E..EE
E.EE.EEEE....E...E.EE...EE.EEEE.EEEEE.EE
E.E..EEE..EEEEEEEE.EE.EEEE..EEE.......EE
E.E.EEE..EEE.......EE.EEEEE..EEEEEE.EEEE
E.E.EEE.EEEE.EEEEEEEE.EEEEEE.EEEEEE.EEEE
E.E.EEE..EEE.EEEEEEEE.EEEEE..EEEEEE.EEEE
E.E.EEEE.EEE....EEEEE..EEE..EEEEEE..EEEE
E.E.EEEE.EEEEEE.EEEEEE.E...EEEEEE..EEEEE
E.E.EEE..EEEEE...EEEEEE..EEEEEEE..EEEEEE
E.E..EE.E...E..E..EEEE..EEEEE....EE...EE
E.EE..E...E...E.E......EEEEE..EE.E..E.EE
E...E..EEEEEEE..EEEEEEE......EEE.E.E..EE
EEE.EE.....EEEE.........EE.EEEEE.E.E.E.E
E.....EEEE......EEEEEEEEEE..EEEE...E...E
EEEEEEEEEEEEEEEEEEEEEEEEEEEEEEEEEEEEEEEE
