SSSSSSSSSSSSSSS>SSSSSSSSSSSSSSSSSSSSSSSS
SS,,,SSSSSSSSS,,SSSSSSSSSSSSSSSSSS,,,,SS
S,,S,SSSSSSSSS,SSSSSSSSSSSSSSSSSS,,SS,,S
S,SS,,,,,,SSSS,,,,SSSSSSS,,,SSSSS,SSSS,S
S,,SSSSSS,,SSSSSS,SSSSSSS,S,,SSSS,SS,,,S
SS,,,SSSSS,,,SSSS,,SSSSSS,SS,,SS,,SS,SSS
SSSS,SSSSSSS,SSSSS,,,,SSS,SSS,,,,SSS,SSS
SSSS,,SSSSSS,,,SSSSSS,SS,,,SSSSSSS,,,SSS
SSSSS,SSSSSSSS,,SSSSS,,,,SSSSSSSSS,SSSSS
SSSSS,SSSSSSSSS,,,,SSSSSSSSSSSSSSS,SSSSS
SSSSS,,SSSSSSSSSSS,SSSSSSSSSSSSSSS,SSSSS
SSSSSS,SSSSSSSSSSS,,,,,,SSSS,,,,SS,SSSSS
SS,,,S,,SSS,,,SSSSSSSSS,SSSS,SS,,,,,SSSS
S,,S,SS,SSS,S,,SSSSSSS,,SSS,,SSSSSSKSS,S
S,SS,SS,SSS,SS,SS,,,,,,S,,,,SSSSSSSSSS,S
S,S,,SS,SSSSSS,SS,SSSSS,,SSSS,,,SSS,S,,S
S,S,SS,,SSSSS,,SS,,,,,,,S,,S,,S,,,,,,,SS
S,S,,,,SSSSSS,SSSSSSSS,,SS,,,SS,SSS,,SSS
S,,SS,SSSSSS,,SSSS,,,S,,,,,S,SS,S,,,SSSS
SS,SS,,SSSSS,SSSSS,S,SS,SSSSSSS,S,SSSSSS
SS,,,S,SSSSS,,,SSS,S,,S,,,SSSSS,S,,,,SSS
S,,SS,,,,SS,SS,,SS,SS,,SS,SS,,,,,SSS,,SS
S,S,,,S,SSS,,,S,,,,SSS,S,,SS,SSS,,S,S,,S
SS,,SSS,,,,,S,,SSSSSSS,S,S,,,SSSS,,,,S,S
S,,S,,,SS,S,,S,S,,,SS,,,,S,S,SSS,,SS,S,S
SS,,,S,S,,S,SS,S,S,SSS,S,,,,,SSS,S,,,,,S
S,,,S,,,,S,,SS,,,,,S,,,,,SS,SSSS,,S,SS,S
S,S,,,S,S,,SSSS,S,SS,SSS,SS,,SSSS,S,,S,S
S,SSSSS,,,S,,,,,SS,,,S,,,,,,,,,,S,,,,,,S
S,SSSSSSSSS,SSSSS,,SS,,SSS,SSSS,,SSS,SSS
S,,SSSSSSSS,SSSS,,SSS,SSSS,SSSSS,,SS,,,S
SS,SSSSSSSS,SSSS,SSSS,,,SS,,SSS,S,,,SS,S
S,,,SSSSSSS,,SSS,,,,,SS,,SS,,SS,,SS,,,,S
S,S,,SSSSSSS,SSSSSSS,,SS,SSS,SSS,SS,S,SS
S,,S,,SSSSSS,,,,,SSSS,,,S,SS,SSS,,,,,,,S
S,SSS,SSSSSSSSSS,,SSSSS,,,,S,SSS,S,S,S,S
S,,,S,,SS,,,,,SSS,,,,,,SSSSS,SS,,,,S,S,S
S,S,SS,SS,,SS,,,,SSSSS,,,,,,SSS,SS,,SS,S
S,,,,S,,,,SSSSSS,,,,,,,S,SS,,,,,SSS,,,,S
SSSSSSSSSSSSSSSSSSSSSSSSSSSSSSSSSSSSSSSS
