BBBBBBBBBB
B...W....B
B...W....B
B...W....B
BWVWWWWVWB
B........B
BWVWW....B
B...W....B
B...W....B
BBBBBdBBBB
