_QQQQ__Q___QQQQ_MMHHHMMMMHHHMMHMMMHHMMM_HHMMHHMHHM
QQ_Q_QQ_QQQ__Q_QHMMMMHHHHMMMMHMMHHMMMHMMMMHHMMHMHH
QQ_________Q_Q_HHHHHHHHHHHHHHHHHHMHHHHHMHHHHHHHHMM
Q______Q_____QHHHHHHHHHHHHHHH__HHQHQHHMH_HQHHHHHHM
QQ__HHH___H_HQHHHHHHHHHQHHHQ_H___QHHQHHH___QQHHHMH
_QQHHHH_HH__HHMMHHHHHHQHHQQHHH_H_QQ_HQHH____QQHHQH
QQ___HHHHH___HHMMHHHHHHH__________Q__QH_____Q_Q__Q
QQ_HH__HHHH__HHMHHHHHHH___QQQ___Q__QQ_______QHQ_HQ
_Q____Q__QQHQ_HMHQHHMMHHQQ__QQ____QHQ___QQ__Q___HM
__QQQQ_QQ_Q_HHMHHHHHHMMMHQQQQ_QQ___QQQ___QQ_Q__QQQ
_QQ_______Q_HHMHHHHMHMHHHHH_______QQ_______HHQQ__M
Q____Q_QHH__HHHMHHHMMMHHH__HH____QQ____QHHHHHH__HM
QQ__Q______Q__QMHHMMMHHHQHHHH_HH_Q_Q_Q_Q__HHMHHHHM
Q_____Q__Q__QQHMHHHMHHHHHMHHHHHMQ_QQ_QQ___HMMMHHMH
_Q_QQQQQQ_QQ_HHMHHHMHQHHHHMMMHHMHH____HHHHMMHMHHMM
_Q__Q_____QQ__QMHQHMHHHHHHHHHMMHHH_Q___HHHHHHMMMHM
Q___H__HHH_QHHMHHHMHMHMMHHHHHHMHHHQH___QHHMMMMMQHM
Q_____HHHHHHHHHHHHHQMMQHHQHHHHHMMHH_QHHHHMMHHHHHHM
_QQ__Q_QQQ_QH_Q_HHQMMMHHMMMMHHHHHHMHMMMHMMHMMMHQMH
_Q_QQ_QQ_HQQQQ_QQQ__MMMMHQHMMMMMMMMMMHHMMMQHHMMHMH
