BBBBBBBBBB
B........B
B.WW..WW.B
B........B
B........B
B.WWWWWW.B
B........B
B.WW..WW.B
B.W....W.B
BBBBBdBBBB
