BBBBBBBBBB
B...W....B
B...W....B
B...W....B
B...W....B
B........B
B...W....B
B...W....B
B...W....B
BBBBB>BBBB
