BBB<BB>BBB
B...B....B
B.BBBBBB.B
B.B....B.B
B.B.BB.B.B
B.B..B.B.B
B.B..B.B.B
B.B.B..B.B
B...B....B
BBBBBBBBBB
