BBB<BB>BBB
B....B...B
B.BBBBBB.B
B.B....B.B
B.B.B....B
B.B.BBBBBB
B.B......B
B.BBBBB..B
B........B
BBBBBBBBBB
