BBBBBBBBBB
B........B
B........B
B.WWWWWW.B
B.W....W.B
B.W....W.B
B.W....W.B
B.W....W.B
B.W....W.B
BBBBBdBBBB
